1111111111111110000000000111111111111111
1011111111101110112222110111001111111111
1101110111011110112222110111010111111111
1110101010111110112222110111010111111111
1111011101111110111111110111001111111111
1111111111111110111111110111111111111111
1111111111111110111111110111111111111111
1111111111111110111111110111111111111111
1111111111111110111111110111111111111111
1111111111111110111111110111111111111111
1111111111111110111111110111111111111111
1111111111111110111111110111111111111111
1111111111111110111111110111111111111111
1111111111111110111111110111111111111111
1111111111111110000000000111111111111111
-
0,21,11
2,20,1
3,20,13,start.map,22,5