000000000000000000000000000000000000000000
011111111111111111111111111111111111111110
011111111111111111111111111111111111111110
011111111111111111111111111111111111111110
011111111111111111111111111111111111111110
011111111111111111111111111111111111111110
011111111111111111111111111111111111111110
011111111111111111111111111111111111111110
011111111111111111111111111111111111111110
011111111111111111111111111111111111111110
011111111111111111111111111111111111111110
011111111111111111111111111111111111111110
011111111111111111111111111111111111111110
011111111111111111111111111110101111111110
011111111111111111111111111110001111111110
011111111111111111111111111111111111111110
011111111111111111111111111110001111111110
011111111111111111111111111110001111111110
011111111111111111111111111110001111111110
011111111111111111111111111110001111111110
011111111111111111111111111111111111111110
011111111111111111111111111112221111111110
011111111111111111111111111112221111111110
011111111111111111111111111112221111111110
011111111111111111111111111111111111111110
011111111111111111111111111111111111111110
011111111111111111111111111111111111111110
011111111111111111111111111111111111111110
011111111111111111111111111111111111111110
011111111111111111111111111111111111111110
011111111111111111111111111111111111111110
000000000000000000000000000000000000000000
-
0,22,14
1,5,20
3,21,1,northofstart.map,21,14
4,2,2